 #####
##   ##
#  12 #
#     #
#P ####
####
-
 #####
##   ##
#  21 #
#     #
#P ####
####