  ###
 ##!#
 # S####
##   SP#
#! SS!##
#### ##
   # #    #  #
   #!#  
   ###    #### 