 ####
##  #
#P 1##
#    #
# 2  #
##  ##
 ####
-
 ####
##  #
#P  ##
# 12 #
#    #
##  ##
 ####