  #####
###   #
# 1 2 #
#     #
#### P#
   ####
-
  #####
###   #
#2   1#
#     #
#### P#
   ####
