######
#!!!!####
#  S##  #
# SS    #
#PS #   #
##  #####
 ####  