 ######
##    ##
# 1#2  #
#      #
##### P#
    ####
-
 ######
## 1  ##
#  #   #
#  2   #
#####  #
    ####
