###   
#!#####  
#!!   #  
# SSSP#  
#    ##  
######