  ####
  # P### 
  #SS  # 
### S! # 
#!!! ### 
###S #   
  #  #
  ####
  